R 900 900

WE ./wall7.xpm 
EA ./wall8.xpm
NO ./wall9.xpm     
SO ./wall10.xpm    


S ./sp2.xpm   

C 1,42,255  
F 95,52,41


            11111111111111111111                        11111111111111111111    
        111100000000000000000000111111111111111111111111200000000202000000021111
    1111000000000000000000000000000000000000020020002000000200000022200000001111
        11110000000000000000000011111111110001111111111100000000010200000001111
            11111111000111111111          101           11111111000111111111    
                    101                   101                   101
                    101                   101                   101
                    101                   101                   101
                 111000111                101                111000111   
                10000000001               101               10000000001   
                 111000111                101                111000111   
                    101                   101                   101
                    101                   101                   101
                    101                   101                   101
                    10011111111111111111110001111111111111111111001             
                    10000000000000000000002020000000000000000000001             
                    11111111111111111111111011111111111111111111111
                                          101
                                          101
                                           1
                                           1
                                          121
                                          101
                                         12021
                                        1000001
                                         120001
        11111111111111111111111111111111110000111        11111111111111111111   
        111100000000000000000000111111111100201111111111120000000010000000002111
    11110002000000000000000000000000000000000000200020000002000000001000000001111
    1111000010000222222000000000000000000000000000200020000002000000001000000001111
    11110000020000000000000000000000000000000000200020000002000000001000000001111
    1111000000000000N000000000000000000000000000000000000000000000001000000001111
        1111000000000000000000001111111111200111111111110000000001000000000011111
            111111111111111111111        11111111     11111111111111111111111111